29 29 29 29 29 29 29 29 29 29 29 29 29 29 29 29 29 29 29 29 29 29 29 29 29 29 29 29 29 29 29 29 29 29 29 29 29 29 29 29 29 29 29 29 29 29 29 29 29 29 
29 29 29 29 29 29 29 29 29 29 29 29 29 29 29 29 29 29 29 29 29 29 29 29 29 29 29 29 29 29 29 29 29 29 29 29 29 29 29 29 29 29 29 29 29 29 29 29 29 29 
29 29 29 29 29 29 29 29 29 29 29 29 29 29 29 29 29 29 29 29 29 29 29 29 29 29 29 29 29 29 29 29 29 29 29 29 29 29 29 29 29 29 29 29 29 29 29 29 29 29 
29 29 29 18 15 15 15 15 15 15 15 15 15 15 15 15 15 15 15 15 15 15 19 29 29 29 29 29 29 29 29 29 29 18 15 15 15 15 15 15 15 15 15 15 15 15 19 29 29 29 
29 29 29 13 11 11 10 10 10 10 10 10 10 10 10 10 10 27 27 27 10 11 12 29 29 29 29 29 29 29 29 29 29 13 11 11 11 11 11 11 27 11 11 11 11 11 12 29 29 29 
29 29 29 13 10 11 11 11 11 11 11 11 11 10 11 11 11 27 11 27 10 27 12 29 29 29 29 29 29 29 29 29 29 13 10 26 26 26 26 10 27 27 27 27 27 11 12 29 29 29 
29 29 29 13 10 10 11 11 10 10 10 10 11 11 11 11 27 27 11 27 11 27 12 29 29 29 29 29 29 29 29 29 29 13 10 26 11 10 26 11 27 11 11 10 11 11 12 29 29 29 
29 29 29 13 10 10 11 11 11 10 10 11 11 10 10 10 27 27 11 27 10 27 12 29 29 29 29 29 29 29 29 29 29 13 10 26 10 11 26 26 26 26 26 26 10 11 12 29 29 29 
29 29 29 13 10 11 11 11 10 11 10 10 10 11 10 11 11 11 11 27 10 27 12 29 29 29 29 29 29 29 29 29 29 13 10 26 11 26 10 10 26 10 11 26 10 26 12 29 29 29 
29 29 29 13 11 11 10 10 10 10 11 11 10 10 27 27 27 10 10 27 10 27 12 29 29 29 29 29 29 29 29 29 29 13 10 26 11 10 10 10 26 10 11 11 10 26 12 29 29 29 
29 29 29 13 27 11 27 27 27 27 11 11 10 27 27 27 11 27 10 27 11 27 12 29 29 29 29 29 29 29 29 29 29 13 11 26 26 26 26 11 26 10 10 26 26 26 12 29 29 29 
29 29 29 13 25 11 10 27 27 27 27 11 11 27 10 10 10 11 10 10 11 27 12 29 29 29 29 29 29 29 29 29 29 13 11 10 10 10 26 10 26 26 10 11 10 10 12 29 29 29 
29 29 29 13 25 11 11 25 11 25 10 25 11 25 10 10 10 27 27 27 27 27 12 29 29 29 29 29 29 29 29 29 29 13 11 26 26 10 26 10 26 11 26 26 10 26 12 29 29 29 
29 29 29 13 25 10 10 25 10 25 10 25 10 25 25 11 11 11 11 25 11 10 12 29 29 29 29 29 29 29 29 29 29 13 11 26 11 11 26 10 26 10 11 26 10 26 12 29 29 29 
29 29 29 13 25 11 11 25 11 25 11 25 11 11 25 25 10 25 25 25 25 10 12 29 29 29 29 29 29 29 29 29 29 13 11 26 11 26 26 10 11 10 10 26 10 26 12 29 29 29 
29 29 29 13 25 10 11 25 11 25 11 25 11 10 11 25 11 25 25 25 25 10 12 29 29 29 29 29 29 29 29 29 29 13 10 26 11 26 10 10 26 26 26 26 10 26 12 29 29 29 
29 29 29 13 10 10 25 25 11 10 11 25 11 11 11 25 10 11 11 10 11 10 12 29 29 29 29 29 29 29 29 29 29 13 10 26 10 26 10 10 10 26 10 10 10 26 12 29 29 29 
29 29 29 13 10 10 10 25 11 25 25 25 11 10 10 25 10 11 25 25 25 25 12 29 29 29 29 29 29 29 29 29 29 13 10 26 10 26 10 10 10 26 10 26 26 26 12 29 29 29 
29 29 29 13 10 25 11 25 10 11 11 11 10 10 10 25 25 11 25 11 11 10 12 29 29 29 29 29 29 29 29 29 29 13 10 10 10 26 10 26 26 26 10 10 26 10 12 29 29 29 
29 29 29 13 11 25 10 25 25 25 25 11 25 11 11 11 25 11 25 11 11 25 24 15 15 15 15 15 15 15 15 15 15 23 26 10 26 26 10 10 10 26 10 10 26 10 12 29 29 29 
29 29 29 13 11 25 11 11 11 11 11 11 25 11 25 11 11 11 11 11 11 25 11 25 11 11 11 26 11 11 11 26 10 26 10 10 26 10 10 10 10 26 26 10 26 10 12 29 29 29 
29 29 29 13 25 25 25 25 25 25 25 25 25 25 25 25 25 25 25 25 25 25 11 25 11 11 11 26 26 26 11 26 10 26 10 26 26 10 10 10 10 10 26 10 26 10 12 29 29 29 
29 29 29 13 11 11 11 11 11 11 25 11 11 11 11 11 11 11 11 11 11 11 11 25 11 26 11 11 11 11 11 26 10 26 10 26 10 10 26 10 26 26 26 10 26 26 12 29 29 29 
29 29 29 13 11 11 25 11 25 11 25 25 25 25 25 25 25 25 11 25 25 25 25 25 11 26 26 26 26 26 11 26 10 11 10 10 10 26 26 10 10 10 26 10 26 10 12 29 29 29 
29 29 29 13 25 11 25 11 25 11 25 11 11 11 25 11 11 25 11 25 11 11 11 11 11 26 11 11 11 11 11 26 10 26 10 26 26 26 10 10 10 10 10 10 11 10 12 29 29 29 
29 29 29 13 25 11 25 11 25 11 25 11 25 11 25 11 11 25 11 11 11 25 25 25 25 26 11 26 26 11 26 26 10 26 10 10 10 10 10 10 26 26 26 26 26 10 12 29 29 29 
29 29 29 13 25 25 25 11 11 11 11 11 25 11 11 11 11 11 11 11 11 25 11 11 11 11 11 11 26 26 11 11 10 26 10 26 10 26 10 10 10 10 26 10 10 10 12 29 29 29 
29 29 29 13 11 11 25 25 25 25 25 25 25 25 25 25 25 25 25 25 25 25 11 11 11 26 11 11 26 11 11 11 10 10 10 26 10 26 26 26 26 26 26 10 26 10 12 29 29 29 
29 29 29 13 11 11 11 11 11 11 11 11 11 11 11 11 11 11 11 11 11 11 11 11 26 26 11 26 26 26 26 26 10 10 26 10 10 26 10 10 10 10 10 10 26 10 12 29 29 29 
29 29 29 13 11 25 11 11 25 25 25 25 11 25 25 25 25 25 25 25 25 25 26 26 26 11 11 11 11 11 11 11 10 26 10 10 26 26 10 26 26 26 26 26 26 10 12 29 29 29 
29 29 29 13 11 25 11 11 25 11 11 25 11 25 11 11 11 11 11 11 11 27 22 14 14 14 14 14 14 14 14 14 14 21 26 26 26 10 10 10 10 10 10 10 10 10 12 29 29 29 
29 29 29 13 11 25 11 25 11 11 25 25 11 25 11 27 11 11 11 11 27 11 12 29 29 29 29 29 29 29 29 29 29 13 10 10 26 10 26 26 26 26 26 26 26 10 12 29 29 29 
29 29 29 13 11 25 11 25 25 11 11 11 11 11 11 27 11 27 11 27 11 11 12 29 29 29 29 29 29 29 29 29 29 13 10 10 26 10 10 10 10 26 10 10 10 10 12 29 29 29 
29 29 29 13 11 25 11 11 25 25 11 11 25 25 25 27 27 27 27 27 27 11 12 29 29 29 29 29 29 29 29 29 29 13 10 10 26 10 26 26 10 26 27 26 26 26 12 29 29 29 
29 29 29 13 11 25 11 11 11 25 25 25 25 11 11 27 11 11 27 11 11 11 12 29 29 29 29 29 29 29 29 29 29 13 26 11 11 10 10 10 11 26 10 10 10 11 12 29 29 29 
29 29 29 13 11 25 25 11 10 10 10 10 11 11 11 27 11 11 27 27 27 11 12 29 29 29 29 29 29 29 29 29 29 13 26 26 26 26 26 10 11 26 10 10 26 11 12 29 29 29 
29 29 29 13 10 25 25 25 25 25 25 27 11 27 27 27 11 11 27 11 27 11 12 29 29 29 29 29 29 29 29 29 29 13 11 11 11 26 10 10 11 10 10 11 26 10 12 29 29 29 
29 29 29 13 10 11 11 25 11 10 11 11 10 11 27 27 27 27 27 11 27 10 12 29 29 29 29 29 29 29 29 29 29 13 10 26 11 26 10 10 26 26 26 27 26 10 12 29 29 29 
29 29 29 13 11 11 25 25 10 11 25 11 10 27 10 27 11 11 27 11 27 10 12 29 29 29 29 29 29 29 29 29 29 13 10 26 11 26 10 11 11 11 11 10 26 10 12 29 29 29 
29 29 29 13 11 25 25 11 10 10 25 10 11 27 11 11 11 10 27 11 11 10 12 29 29 29 29 29 29 29 29 29 29 13 10 26 10 10 11 26 26 26 10 10 26 10 12 29 29 29 
29 29 29 13 11 10 25 25 25 25 25 25 11 27 10 11 27 27 27 11 11 27 12 29 29 29 29 29 29 29 29 29 29 13 10 11 11 10 11 26 11 10 26 26 26 10 12 29 29 29 
29 29 29 13 11 10 25 11 11 25 25 11 10 10 10 10 11 27 10 11 11 27 12 29 29 29 29 29 29 29 29 29 29 13 10 26 26 26 26 26 11 10 10 10 10 10 12 29 29 29 
29 29 29 13 11 25 25 25 11 11 25 11 10 27 27 27 27 27 10 27 11 27 12 29 29 29 29 29 29 29 29 29 29 13 10 26 11 11 10 11 11 11 10 10 10 10 12 29 29 29 
29 29 29 13 10 25 10 25 11 10 10 11 10 10 10 10 27 11 11 27 11 10 12 29 29 29 29 29 29 29 29 29 29 13 26 26 26 26 26 11 11 26 26 26 10 10 12 29 29 29 
29 29 29 13 10 25 11 25 25 25 25 25 25 25 11 11 27 11 27 27 27 10 12 29 29 29 29 29 29 29 29 29 29 13 11 11 11 26 26 26 26 26 11 26 26 26 12 29 29 29 
29 29 29 13 10 10 11 11 11 11 11 11 11 11 11 11 27 10 10 10 10 10 12 29 29 29 29 29 29 29 29 29 29 13 11 11 11 26 11 11 11 11 11 11 11 11 12 29 29 29 
29 29 29 17 14 14 14 14 14 14 14 14 14 14 14 14 14 14 14 14 14 14 16 29 29 29 29 29 29 29 29 29 29 17 14 14 14 14 14 14 14 14 14 14 14 14 16 29 29 29 
29 29 29 29 29 29 29 29 29 29 29 29 29 29 29 29 29 29 29 29 29 29 29 29 29 29 29 29 29 29 29 29 29 29 29 29 29 29 29 29 29 29 29 29 29 29 29 29 29 29 
29 29 29 29 29 29 29 29 29 29 29 29 29 29 29 29 29 29 29 29 29 29 29 29 29 29 29 29 29 29 29 29 29 29 29 29 29 29 29 29 29 29 29 29 29 29 29 29 29 29 
29 29 29 29 29 29 29 29 29 29 29 29 29 29 29 29 29 29 29 29 29 29 29 29 29 29 29 29 29 29 29 29 29 29 29 29 29 29 29 29 29 29 29 29 29 29 29 29 29 29 
