29 29 29 29 29 29 29 29 29 29 29 29 29 29 29 29 29 29 29 29 29 29 29 29 29 29 29 29 29 29 29 29 29 29 29 29 29 29 29 29 29 29 29 29 29 29 29 29 29 29 
29 29 29 29 29 29 29 29 29 29 29 29 29 29 29 29 29 29 29 29 29 29 29 29 29 29 29 29 29 29 29 29 29 29 29 29 29 29 29 29 29 29 29 29 29 29 29 29 29 29 
29 29 29 29 29 29 29 29 29 29 29 29 29 29 29 29 29 29 29 29 29 29 29 29 29 29 29 29 29 29 29 29 29 29 29 29 29 29 29 29 29 29 29 29 29 29 29 29 29 29 
29 29 29 18 15 15 15 15 15 15 15 15 15 15 15 15 15 15 15 15 15 15 15 15 15 15 15 15 15 19 29 29 29 29 29 29 29 29 29 29 29 29 29 29 29 29 29 29 29 29 
29 29 29 13 11 11 11 11 11 11 11 27 27 27 27 27 27 27 27 27 27 27 11 11 11 11 11 11 11 12 29 29 29 29 29 29 29 29 29 29 29 29 29 29 29 29 29 29 29 29 
29 29 29 13 11 11 27 11 27 11 11 11 11 11 27 11 10 11 11 11 27 27 27 27 11 27 27 27 11 12 29 29 29 29 29 29 29 29 29 29 29 29 29 29 29 29 29 29 29 29 
29 29 29 13 27 11 27 11 27 11 11 11 11 11 27 11 27 27 11 11 11 27 11 27 11 11 11 27 11 24 15 15 15 15 15 15 15 15 15 15 15 15 15 15 15 15 19 29 29 29 
29 29 29 13 27 11 27 11 27 27 27 27 27 27 27 11 27 27 11 27 11 27 11 11 11 11 11 27 11 11 11 11 27 27 27 11 11 27 27 27 11 11 11 27 11 11 12 29 29 29 
29 29 29 13 27 11 11 11 11 11 11 11 11 11 27 11 11 27 11 27 11 27 11 11 27 27 27 27 27 11 11 11 11 11 27 11 11 11 11 27 11 27 27 27 27 11 12 29 29 29 
29 29 29 13 27 27 27 27 11 27 27 11 27 11 27 11 11 27 11 27 11 27 27 11 11 27 11 11 27 11 11 27 11 11 27 11 11 27 11 27 11 11 11 11 11 11 12 29 29 29 
29 29 29 13 11 11 11 11 11 27 11 11 11 11 27 11 11 27 27 27 27 27 11 11 11 27 27 11 27 11 11 27 27 27 27 27 27 27 11 11 11 27 27 27 27 11 12 29 29 29 
29 29 29 13 27 11 27 27 27 27 11 27 11 11 27 11 11 10 11 11 11 27 27 11 11 11 27 11 27 11 11 11 11 11 27 11 11 27 27 27 11 27 11 11 11 11 12 29 29 29 
29 29 29 13 11 11 11 11 11 11 11 27 27 11 11 11 11 27 11 27 11 27 27 11 11 11 27 11 27 27 11 27 27 27 27 11 11 11 11 11 11 27 11 27 11 11 12 29 29 29 
29 29 29 13 27 27 27 27 27 27 27 27 11 11 27 27 27 27 11 27 11 11 11 11 11 11 27 11 27 11 11 11 11 11 11 11 11 27 27 27 11 11 11 27 27 11 12 29 29 29 
29 29 29 13 11 11 11 27 11 11 11 11 11 11 11 11 11 11 11 27 11 27 11 27 27 27 27 11 11 22 14 14 14 14 14 14 14 14 14 21 11 27 11 27 27 11 12 29 29 29 
29 29 29 13 27 27 11 27 27 27 27 27 27 27 27 27 27 27 27 27 11 27 11 11 11 11 27 27 11 12 29 29 29 29 29 29 29 29 29 13 11 27 11 27 11 11 12 29 29 29 
29 29 29 13 27 11 11 11 11 11 11 11 11 11 11 11 11 11 11 11 11 11 11 27 27 11 11 11 11 12 29 29 29 29 29 29 29 29 29 13 11 27 11 27 11 11 12 29 29 29 
29 29 29 17 14 14 14 14 14 14 14 14 14 14 21 11 27 11 22 14 14 14 14 14 14 14 14 14 14 16 29 29 29 29 29 29 29 29 29 13 11 27 11 27 11 11 12 29 29 29 
29 29 29 29 29 29 29 29 29 29 29 29 29 29 13 11 27 11 12 29 29 29 29 29 29 29 29 29 29 29 29 29 29 29 29 29 29 29 29 13 27 27 11 27 27 27 12 29 29 29 
29 29 29 29 29 29 29 29 29 29 29 29 29 29 13 11 27 27 12 29 29 29 29 29 29 29 29 29 29 29 29 29 29 29 29 29 29 29 29 13 27 11 11 11 11 11 12 29 29 29 
29 29 29 29 29 29 29 29 29 29 29 29 29 29 13 11 10 11 12 29 29 29 29 29 29 29 29 29 29 29 29 29 29 29 29 29 29 29 29 13 11 11 11 11 11 10 12 29 29 29 
29 29 29 29 29 29 29 29 29 29 29 29 29 29 13 27 27 11 12 29 29 29 29 29 29 29 29 29 29 29 29 29 29 29 29 29 29 29 29 13 11 11 10 10 10 10 12 29 29 29 
29 29 29 29 29 29 29 29 29 29 29 29 29 29 13 11 27 11 12 29 29 29 29 29 29 29 29 29 29 29 29 29 29 29 29 29 29 29 29 13 11 10 10 10 10 10 12 29 29 29 
29 29 29 29 29 29 29 29 29 29 29 29 29 29 13 11 10 11 12 29 29 29 29 29 29 29 29 29 29 29 29 29 29 29 29 29 29 29 29 13 11 10 11 10 10 10 12 29 29 29 
29 29 29 29 29 29 29 29 29 29 29 29 29 29 13 11 27 27 12 29 29 29 29 29 29 29 29 29 29 29 29 29 29 29 29 29 29 29 29 13 11 10 11 10 10 11 12 29 29 29 
29 29 29 29 29 29 29 29 29 29 29 29 29 29 13 11 10 11 12 29 29 29 29 29 29 29 29 29 29 29 29 29 29 29 29 29 29 29 29 13 11 10 10 10 10 11 12 29 29 29 
29 29 29 18 15 15 15 15 15 15 15 15 15 15 23 11 27 11 24 15 15 15 15 15 15 15 15 15 15 19 29 29 29 29 29 29 29 29 29 13 27 10 11 10 10 11 12 29 29 29 
29 29 29 13 27 27 27 27 27 27 27 27 27 11 11 11 27 11 11 10 11 11 11 11 11 11 11 27 27 12 29 29 29 29 29 29 29 29 29 13 27 27 27 10 27 27 12 29 29 29 
29 29 29 13 11 10 27 11 10 10 27 10 27 27 11 27 27 27 27 27 27 27 27 27 27 27 10 11 11 12 29 29 29 29 29 29 29 29 29 13 11 10 27 10 10 11 12 29 29 29 
29 29 29 13 10 27 27 11 27 11 27 11 11 27 10 27 10 27 27 10 27 11 10 27 10 27 27 27 11 24 15 15 15 15 15 15 15 15 15 23 11 27 11 10 10 11 12 29 29 29 
29 29 29 13 10 11 27 10 27 27 27 10 10 27 11 27 11 11 11 11 27 27 10 11 11 27 11 27 27 27 27 27 27 10 10 10 10 10 10 27 10 27 27 27 10 27 12 29 29 29 
29 29 29 13 27 10 27 10 10 10 10 10 27 27 11 11 11 11 27 27 27 27 27 10 27 27 10 27 10 10 10 10 27 27 27 27 27 27 11 27 11 27 11 11 10 27 12 29 29 29 
29 29 29 13 11 10 27 27 27 27 10 10 10 27 27 10 27 10 10 27 10 11 11 10 10 27 10 10 11 11 27 10 27 10 10 10 10 11 10 27 11 10 10 10 10 27 12 29 29 29 
29 29 29 13 11 27 11 27 10 11 10 11 10 27 27 10 27 27 27 27 10 27 27 27 27 27 11 11 11 27 27 11 27 27 10 27 10 27 10 10 11 11 11 27 27 27 12 29 29 29 
29 29 29 13 11 27 27 27 10 11 27 10 10 10 10 10 10 10 10 27 11 27 10 10 10 10 10 27 10 10 27 10 10 10 10 27 10 27 27 27 27 10 10 10 27 11 12 29 29 29 
29 29 29 13 11 10 10 27 10 10 27 27 27 27 27 27 10 27 10 10 10 27 27 27 27 27 11 27 27 27 27 27 27 27 10 27 10 27 10 10 10 27 27 27 27 11 12 29 29 29 
29 29 29 13 11 27 27 27 27 27 27 11 27 27 10 11 11 27 27 27 11 27 11 27 11 11 10 27 10 11 11 11 10 10 10 27 11 11 11 11 11 11 11 11 11 11 12 29 29 29 
29 29 29 13 11 11 27 10 10 27 11 10 10 27 27 27 27 27 10 10 10 27 10 27 27 27 27 27 11 22 14 14 14 14 14 14 14 14 14 14 14 14 14 14 14 14 16 29 29 29 
29 29 29 13 11 11 27 10 10 10 10 27 27 27 11 11 27 11 11 27 27 27 11 27 10 11 11 11 11 12 29 29 29 29 29 29 29 29 29 29 29 29 29 29 29 29 29 29 29 29 
29 29 29 13 11 11 11 10 10 11 11 11 11 11 11 11 11 11 11 11 10 10 10 10 11 11 11 11 11 12 29 29 29 29 29 29 29 29 29 29 29 29 29 29 29 29 29 29 29 29 
29 29 29 17 14 14 14 14 14 14 14 14 14 14 14 14 14 14 14 14 14 14 14 14 14 14 14 14 14 16 29 29 29 29 29 29 29 29 29 29 29 29 29 29 29 29 29 29 29 29 
29 29 29 29 29 29 29 29 29 29 29 29 29 29 29 29 29 29 29 29 29 29 29 29 29 29 29 29 29 29 29 29 29 29 29 29 29 29 29 29 29 29 29 29 29 29 29 29 29 29 
29 29 29 29 29 29 29 29 29 29 29 29 29 29 29 29 29 29 29 29 29 29 29 29 29 29 29 29 29 29 29 29 29 29 29 29 29 29 29 29 29 29 29 29 29 29 29 29 29 29 
29 29 29 29 29 29 29 29 29 29 29 29 29 29 29 29 29 29 29 29 29 29 29 29 29 29 29 29 29 29 29 29 29 29 29 29 29 29 29 29 29 29 29 29 29 29 29 29 29 29 
29 29 29 29 29 29 29 29 29 29 29 29 29 29 29 29 29 29 29 29 29 29 29 29 29 29 29 29 29 29 29 29 29 29 29 29 29 29 29 29 29 29 29 29 29 29 29 29 29 29 
29 29 29 29 29 29 29 29 29 29 29 29 29 29 29 29 29 29 29 29 29 29 29 29 29 29 29 29 29 29 29 29 29 29 29 29 29 29 29 29 29 29 29 29 29 29 29 29 29 29 
29 29 29 29 29 29 29 29 29 29 29 29 29 29 29 29 29 29 29 29 29 29 29 29 29 29 29 29 29 29 29 29 29 29 29 29 29 29 29 29 29 29 29 29 29 29 29 29 29 29 
29 29 29 29 29 29 29 29 29 29 29 29 29 29 29 29 29 29 29 29 29 29 29 29 29 29 29 29 29 29 29 29 29 29 29 29 29 29 29 29 29 29 29 29 29 29 29 29 29 29 
29 29 29 29 29 29 29 29 29 29 29 29 29 29 29 29 29 29 29 29 29 29 29 29 29 29 29 29 29 29 29 29 29 29 29 29 29 29 29 29 29 29 29 29 29 29 29 29 29 29 
29 29 29 29 29 29 29 29 29 29 29 29 29 29 29 29 29 29 29 29 29 29 29 29 29 29 29 29 29 29 29 29 29 29 29 29 29 29 29 29 29 29 29 29 29 29 29 29 29 29 
