25 25 25 25 25 25 25 25 25 25 25 25 25 25 25 25 25 25 25 25 25 25 25 25 25 11 11 11 11 11 11 11 11 11 11 11 11 25 25 25 25 25 25 25 25 25 25 25 25 25 
25 11 11 25 25 25 11 11 11 11 11 11 11 25 25 25 25 11 11 25 11 25 25 25 25 25 25 25 25 25 25 25 25 11 25 25 11 11 11 11 11 25 25 25 11 11 11 25 25 25 
25 25 11 11 11 11 11 11 25 25 25 25 11 25 25 25 11 11 25 11 11 25 11 11 11 11 11 11 11 11 25 25 11 11 11 25 25 25 25 25 11 11 11 25 25 25 11 11 11 25 
25 25 25 11 11 25 25 11 25 25 25 25 11 25 25 11 11 25 11 11 25 11 11 11 11 11 11 11 11 11 25 25 25 25 11 11 11 25 25 25 11 25 11 11 25 25 25 11 25 25 
25 25 25 11 25 25 25 11 11 11 25 25 11 25 25 11 25 11 11 25 11 11 11 11 11 11 11 11 11 11 25 25 25 25 25 25 11 11 25 25 11 25 25 11 11 25 11 11 25 25 
25 25 11 11 25 11 11 11 25 25 25 25 11 25 25 11 25 11 11 25 11 11 11 11 11 11 11 11 11 11 11 11 11 11 11 25 25 11 25 25 11 25 25 25 11 25 11 25 25 11 
25 25 11 25 25 25 25 11 25 25 25 11 25 11 11 11 25 11 11 11 11 11 11 11 11 11 11 11 11 11 25 25 11 25 11 25 25 11 25 25 11 25 25 25 11 11 11 11 11 11 
25 25 11 25 11 25 25 11 25 25 25 11 25 25 11 11 25 11 25 25 11 11 11 11 11 11 11 11 11 11 25 25 11 25 11 25 25 11 25 25 11 25 25 11 11 11 11 11 25 25 
25 25 11 25 11 25 25 11 25 25 11 11 25 25 25 11 25 11 11 11 25 11 11 11 11 11 11 11 11 11 25 25 11 25 11 25 25 11 25 11 11 25 11 11 25 25 11 11 11 25 
25 25 11 11 11 25 25 11 25 25 11 25 25 25 25 11 25 25 25 11 25 11 11 11 11 11 11 11 11 25 25 25 11 25 11 25 25 25 25 25 11 25 25 25 25 25 11 25 11 11 
25 25 25 11 11 11 25 11 25 11 11 25 11 25 25 11 11 11 25 25 25 25 25 25 25 11 25 25 25 25 25 11 11 25 11 25 25 25 25 25 11 25 25 25 25 25 11 25 25 25 
25 25 25 25 11 11 25 11 25 11 25 25 11 11 25 11 25 11 11 11 11 11 11 25 11 11 25 25 11 11 11 11 25 25 11 11 11 11 11 11 11 11 11 11 11 11 11 25 25 25 
25 25 25 11 11 25 25 11 11 25 25 25 25 11 11 11 25 25 25 25 25 25 11 11 11 25 11 11 11 11 11 11 25 25 25 25 25 25 25 25 25 25 25 25 25 11 11 11 25 25 
25 11 11 11 25 25 25 11 11 25 25 25 25 25 25 25 25 25 25 25 25 25 25 25 11 11 11 25 25 25 25 11 11 11 11 11 11 25 25 25 25 25 25 25 25 25 25 11 11 25 
11 11 25 25 25 25 11 11 25 25 22 14 14 14 14 14 14 14 14 14 14 14 14 14 14 14 14 14 14 14 14 14 14 14 14 14 14 14 14 14 14 21 25 25 25 25 25 25 11 25 
25 25 25 25 25 11 11 25 25 25 12 29 29 29 29 29 29 29 29 29 29 29 29 29 29 29 29 29 29 29 29 29 29 29 29 29 29 29 29 29 29 13 25 25 25 11 11 11 11 25 
25 25 25 11 25 11 25 25 25 25 12 29 29 29 29 29 29 29 29 29 29 29 29 29 29 29 29 29 29 29 29 29 29 29 29 29 29 29 29 29 29 13 25 11 11 11 25 25 11 25 
25 25 25 11 11 11 25 25 11 25 12 29 29 29 29 29 29 29 29 29 29 29 29 29 29 29 29 29 29 29 29 29 29 29 29 29 29 29 29 29 29 13 25 11 25 25 25 25 11 25 
25 25 25 11 25 11 25 25 11 25 12 29 29 29 29 29 29 29 29 29 29 29 29 29 29 29 29 29 29 29 29 29 29 29 29 29 29 29 29 29 29 13 25 25 25 25 25 25 11 25 
25 11 25 11 25 11 25 25 11 25 12 29 29 29 29 29 29 29 29 29 29 29 29 29 29 29 29 29 29 29 29 29 29 29 29 29 29 29 29 29 29 13 25 25 25 11 11 11 11 25 
25 11 25 11 25 11 25 25 11 25 12 29 29 29 29 29 29 29 29 29 29 29 29 29 29 29 29 29 29 29 29 29 29 29 29 29 29 29 29 29 29 13 25 11 11 11 25 25 25 25 
25 11 25 11 11 11 11 11 11 25 12 29 29 29 29 29 29 29 29 29 29 29 29 29 29 29 29 29 29 29 29 29 29 29 29 29 29 29 29 29 29 13 25 11 25 25 25 25 25 25 
25 11 25 25 25 11 25 25 25 25 12 29 29 29 29 29 29 29 29 29 29 29 29 29 29 29 29 29 29 29 29 29 29 29 29 29 29 29 29 29 29 13 25 11 25 11 11 25 25 25 
25 11 25 25 25 11 25 25 25 25 12 29 29 29 29 29 29 29 29 29 29 29 29 29 29 29 29 29 29 29 29 29 29 29 29 29 29 29 29 29 29 13 25 11 25 25 11 25 25 25 
25 11 11 25 25 11 11 11 11 25 12 29 29 29 29 29 29 29 29 29 29 29 29 29 29 29 29 29 29 29 29 29 29 29 29 29 29 29 29 29 29 13 25 11 25 25 11 11 25 25 
25 25 11 11 11 25 25 25 11 25 12 29 29 29 29 29 29 29 29 29 29 29 29 29 29 29 29 29 29 29 29 29 29 29 29 29 29 29 29 29 29 13 25 11 25 25 25 11 25 25 
25 25 11 25 25 25 25 25 11 25 12 29 29 29 29 29 29 29 29 29 29 29 29 29 29 29 29 29 29 29 29 29 29 29 29 29 29 29 29 29 29 13 25 11 11 25 25 11 11 25 
25 25 11 25 25 25 25 11 11 25 12 29 29 29 29 29 29 29 29 29 29 29 29 29 29 29 29 29 29 29 29 29 29 29 29 29 29 29 29 29 29 13 25 25 11 25 25 25 11 25 
25 25 11 25 11 25 25 11 25 25 12 29 29 29 29 29 29 29 29 29 29 29 29 29 29 29 29 29 29 29 29 29 29 29 29 29 29 29 29 29 29 13 25 25 11 11 25 25 11 25 
25 25 11 11 11 25 25 11 25 25 12 29 29 29 29 29 29 29 29 29 29 29 29 29 29 29 29 29 29 29 29 29 29 29 29 29 29 29 29 29 29 13 25 25 25 11 11 25 11 25 
25 25 25 25 25 25 25 11 25 25 12 29 29 29 29 29 29 29 29 29 29 29 29 29 29 29 29 29 29 29 29 29 29 29 29 29 29 29 29 29 29 13 25 25 25 25 11 11 11 25 
25 25 25 25 25 25 11 11 25 25 24 15 15 15 15 15 15 15 15 15 15 15 15 15 15 15 15 15 15 15 15 15 15 15 15 15 15 15 15 15 15 23 25 25 25 25 25 11 11 25 
11 11 11 11 11 11 11 25 25 25 25 25 25 25 25 25 25 25 25 25 25 25 25 25 25 25 25 25 25 25 25 25 25 25 25 25 25 25 25 25 25 25 25 25 25 25 25 11 25 25 
25 25 25 11 25 25 11 25 25 25 25 11 11 11 11 11 11 11 25 25 25 25 25 25 25 11 11 11 11 11 11 11 25 25 25 11 11 11 11 11 11 11 11 25 25 25 11 11 25 25 
25 25 25 11 25 25 11 25 25 25 25 25 25 25 25 25 25 11 11 11 11 25 11 11 11 25 25 25 25 25 25 11 11 25 25 25 25 25 25 25 25 25 11 11 11 11 11 25 25 25 
25 11 25 11 25 25 25 11 11 11 11 25 25 25 25 25 25 25 25 25 11 11 11 25 25 25 25 11 25 25 25 25 25 11 25 25 25 25 25 25 25 11 11 25 25 11 11 25 25 25 
25 11 25 11 25 25 25 25 25 25 11 11 11 11 11 11 11 11 11 11 11 11 11 11 25 25 25 11 11 25 25 25 25 11 11 11 11 11 11 11 11 11 25 11 11 25 11 11 25 25 
25 11 25 11 11 11 25 25 25 25 25 25 25 25 25 11 11 11 11 25 25 25 11 11 11 11 25 25 11 25 11 11 25 11 25 25 25 25 25 25 25 25 25 25 11 25 25 11 25 25 
25 11 25 11 25 11 11 11 11 11 25 25 25 11 11 11 25 25 25 25 25 25 25 25 25 25 25 25 11 25 11 25 25 11 25 25 11 11 11 11 11 11 25 25 11 25 25 11 25 25 
25 11 25 11 25 25 25 25 25 11 11 11 11 11 25 25 25 25 25 25 25 25 25 25 25 11 25 11 11 25 11 25 25 11 25 25 25 25 25 25 25 11 11 11 11 25 25 11 25 25 
25 11 11 25 25 25 25 25 25 25 25 25 25 11 11 11 11 11 11 11 11 11 11 11 11 11 11 11 25 25 11 25 25 11 11 11 11 11 11 11 11 11 25 25 25 25 11 11 25 25 
25 11 11 25 25 25 25 11 11 11 25 25 25 25 25 25 25 25 11 25 25 25 25 25 25 11 25 25 25 25 11 11 11 11 25 25 25 25 25 25 25 25 25 25 25 25 11 25 25 25 
25 25 11 25 25 25 25 25 25 11 11 25 25 25 25 25 25 11 11 25 25 25 25 25 25 11 11 25 25 25 25 25 25 25 25 25 25 25 25 25 25 25 11 11 25 11 11 25 25 25 
25 25 11 25 25 25 25 25 25 25 25 11 25 25 25 25 25 11 25 25 25 25 25 25 25 25 11 25 25 25 25 11 11 25 25 25 25 11 11 11 25 11 11 25 25 11 25 25 11 25 
25 25 11 11 11 11 25 25 25 25 25 11 25 25 25 25 11 11 11 11 11 25 25 25 25 25 11 11 25 25 25 25 11 11 11 11 11 11 25 25 11 11 25 25 11 25 25 25 11 25 
25 25 25 25 25 11 11 11 11 11 25 11 25 25 11 11 11 11 11 25 11 11 11 11 25 25 25 11 11 25 25 25 25 25 11 11 25 25 25 11 11 25 25 11 11 25 25 25 11 25 
25 25 25 25 25 25 25 11 25 25 11 11 11 11 11 25 25 25 25 25 25 25 25 11 11 11 11 25 11 11 25 25 25 11 11 25 25 11 11 11 25 25 11 11 25 25 25 25 11 25 
25 25 25 25 25 25 11 11 25 25 25 11 11 25 25 25 25 25 25 25 25 25 25 25 25 25 11 11 11 11 11 25 11 11 25 11 11 11 25 25 11 11 11 11 25 25 25 25 11 25 
25 11 11 11 11 11 11 25 25 25 25 25 11 11 11 11 11 11 11 11 11 11 25 25 25 25 25 25 25 11 11 11 11 25 25 11 25 25 11 11 11 25 25 11 11 11 11 11 11 25 
25 25 25 25 25 25 25 25 25 25 25 25 25 25 25 25 25 25 25 25 25 25 25 25 25 25 25 25 25 25 25 25 11 11 11 11 11 11 11 25 25 25 25 25 25 25 25 25 25 25 
