18 15 15 15 15 15 15 15 15 15 15 15 15 15 15 15 15 15 15 15 15 15 15 15 15 15 15 15 15 15 15 15 15 15 15 15 15 15 15 15 15 15 15 15 15 15 15 15 19 19
13 25 11 10 11 11 10 11 11 11 10 10 10 11 10 11 11 10 10 11 10 10 11 11 10 11 10 10 11 11 11 10 10 11 11 10 11 11 11 10 11 10 10 10 10 11 10 11 12 12 
13 11 11 10 11 11 10 10 10 11 11 10 11 11 11 11 10 10 10 10 11 11 11 11 10 10 10 11 11 10 10 11 10 11 10 10 11 10 10 11 11 11 11 10 11 11 10 10 12 12  
13 11 10 11 11 10 11 10 11 11 11 11 11 11 11 11 10 10 10 10 11 10 10 10 10 10 11 11 11 11 10 11 11 11 11 11 11 11 10 10 11 11 10 11 11 11 11 10 12 12  
13 10 11 10 10 11 11 11 11 10 11 11 10 10 10 11 10 10 10 10 11 11 10 11 10 10 10 10 10 11 11 11 10 10 10 11 11 10 10 11 11 11 10 10 10 10 11 11 12 12  
13 10 11 10 10 11 11 10 10 10 10 11 10 11 10 10 11 10 10 10 11 11 11 11 10 10 11 10 10 10 10 10 10 11 11 10 11 11 11 10 11 10 10 11 11 11 10 11 12 12  
13 11 10 10 11 10 10 11 10 11 10 10 10 10 11 10 11 11 10 11 10 11 11 11 10 10 10 11 10 10 11 11 10 11 10 10 10 11 10 11 10 10 11 11 11 10 11 10 12 12  
13 11 11 11 10 11 11 10 10 10 11 11 10 10 11 11 10 11 25 25 25 11 25 25 25 11 10 10 11 11 11 11 11 10 10 11 11 10 11 10 11 10 10 11 10 11 11 10 12 12  
13 11 10 10 10 11 11 11 11 11 10 11 10 11 11 11 11 25 10 11 11 10 11 10 10 25 11 11 10 10 10 10 11 11 11 10 11 11 11 10 10 10 10 10 10 11 11 11 12 12  
13 11 10 11 11 10 10 10 10 10 11 11 10 11 11 10 11 25 11 10 11 25 11 11 11 25 11 10 11 11 10 11 10 10 10 10 10 10 10 11 10 11 10 10 11 10 10 11 12 12  
13 11 11 11 11 11 11 10 10 10 10 11 11 11 11 10 10 25 10 11 10 10 10 10 10 25 10 11 11 11 10 10 11 10 11 11 10 11 10 11 11 10 11 10 11 11 10 11 12 12  
13 10 10 11 11 11 10 11 10 10 11 11 11 11 10 11 11 11 25 11 10 10 11 10 25 11 10 10 11 10 11 11 10 10 11 10 11 10 10 11 10 10 10 10 11 11 10 10 12 12  
13 10 10 11 11 10 11 10 11 11 10 10 10 10 11 11 11 10 10 10 10 11 11 25 10 11 10 10 10 11 10 10 10 11 11 11 11 11 11 10 10 11 10 10 11 10 11 11 12 12  
13 10 10 11 11 11 11 10 11 11 11 10 10 10 11 10 10 11 10 10 25 10 25 11 11 10 10 10 10 11 10 10 10 11 11 11 11 10 11 10 11 10 10 11 11 10 11 10 12 12  
13 11 10 10 11 11 11 10 11 11 10 10 10 11 10 10 10 11 11 10 10 25 11 11 10 11 11 11 10 10 11 11 11 11 10 10 10 10 10 10 10 11 10 11 11 10 11 11 12 12 
13 11 11 11 10 11 10 11 11 11 11 11 11 11 11 11 10 11 11 11 11 10 10 11 11 11 11 10 10 11 10 11 10 10 10 10 10 11 10 11 11 11 10 11 11 10 11 11 12 12  
13 11 10 10 10 10 11 11 10 10 10 11 11 10 10 11 11 10 10 11 11 11 11 10 10 11 10 11 10 10 10 10 10 11 10 11 10 10 11 11 10 10 10 10 10 11 10 11 12 12  
13 11 10 10 11 10 10 11 11 11 11 10 10 11 11 11 11 10 11 11 10 11 10 11 11 11 10 10 10 10 10 10 11 10 10 10 11 11 11 10 10 11 10 11 10 10 10 11 12 12  
13 10 11 11 10 10 11 10 10 11 10 10 10 10 11 11 10 11 11 11 11 11 10 11 11 11 11 10 10 10 10 10 10 10 11 10 11 10 10 11 11 10 11 11 10 10 10 10 12 12  
13 10 11 11 11 11 11 10 10 11 11 10 10 11 10 11 10 10 11 11 10 11 10 10 10 10 11 11 10 11 10 10 10 10 10 11 11 11 10 11 10 11 10 11 11 11 10 10 12 12  
13 11 11 10 11 11 11 10 10 10 10 10 11 10 10 11 10 10 11 11 10 11 10 11 11 11 10 10 11 10 11 10 11 11 11 10 11 10 10 10 11 11 11 10 10 11 10 10 12 12  
13 11 11 11 11 10 10 11 10 11 10 11 10 10 11 11 11 10 10 11 11 10 11 11 11 11 11 11 10 11 11 11 11 10 11 10 11 11 11 10 11 11 10 11 11 10 11 10 12 12  
13 11 11 10 10 11 11 10 10 11 11 10 11 10 10 10 11 10 10 11 10 11 10 10 11 11 11 10 10 10 10 10 10 10 11 10 11 10 11 11 11 11 10 10 10 10 11 10 12 12  
13 11 10 10 10 10 11 11 11 11 10 11 11 10 10 11 10 11 10 11 11 10 10 11 11 11 10 10 10 10 10 10 11 10 11 10 10 10 10 10 11 11 11 10 10 10 10 11 12 12  
13 11 11 11 11 11 11 10 11 11 11 11 11 11 11 10 11 10 10 10 11 10 11 11 11 11 10 11 11 11 11 10 11 11 11 10 11 11 11 11 10 10 11 11 10 11 10 11 12 12  
13 10 10 11 11 10 11 10 10 10 10 11 11 10 11 11 10 10 11 10 10 10 11 11 10 11 10 11 10 10 10 10 11 10 11 11 11 10 11 11 10 11 11 11 11 10 10 10 12 12  
13 11 11 11 10 11 11 10 11 10 10 10 11 10 10 10 11 11 10 11 10 10 10 11 10 11 10 10 11 11 11 11 11 11 10 10 11 10 10 11 11 10 10 11 11 11 10 11 12 12  
13 10 11 11 11 11 11 11 10 11 10 11 11 11 11 10 10 11 11 11 10 10 10 10 11 10 10 10 10 10 11 10 10 11 11 10 10 11 11 10 11 11 10 10 10 10 10 10 12 12  
13 11 10 11 11 11 11 10 10 11 10 10 11 11 10 11 11 10 10 11 11 11 10 11 11 11 10 11 10 11 11 10 10 11 11 11 10 10 10 11 11 10 10 10 10 11 11 11 12 12  
13 10 10 11 11 10 10 11 10 10 10 10 11 10 10 10 10 10 10 11 10 11 11 11 11 11 10 10 11 10 11 10 11 10 11 11 10 10 10 11 10 10 10 10 11 11 11 11 12 12  
13 11 10 10 10 10 10 10 11 11 10 11 10 10 10 10 11 10 11 11 10 11 10 10 11 11 10 11 11 11 11 10 11 10 10 10 11 11 11 10 11 10 10 10 11 11 10 11 12 12  
13 10 11 10 11 10 10 11 11 10 11 11 10 11 10 11 10 11 11 10 10 10 10 11 11 10 11 11 10 10 10 10 10 10 11 11 11 11 10 11 11 10 11 11 11 10 11 11 12 12  
13 10 11 10 10 10 10 11 10 11 11 11 10 10 11 11 11 11 11 10 11 11 10 10 11 11 10 10 10 10 11 10 11 11 11 11 11 10 11 10 11 11 10 11 10 11 11 10 12 12  
13 11 11 10 10 11 11 10 10 10 11 11 10 11 10 11 11 10 11 10 10 11 10 11 11 11 11 11 10 10 11 10 10 10 11 10 10 10 10 11 11 11 11 11 10 11 11 11 12 12  
13 11 11 11 10 10 11 10 11 10 11 11 11 11 10 10 11 11 11 11 10 10 10 11 11 11 10 11 10 10 11 10 10 11 11 11 10 11 11 10 11 10 10 10 10 10 10 10 12 12  
13 11 11 11 10 10 10 11 11 11 10 10 11 10 10 11 11 11 10 10 11 11 10 11 11 10 10 11 11 11 10 10 10 10 11 10 11 10 10 10 11 10 11 11 11 10 10 10 12 12  
13 10 11 11 10 11 10 11 11 10 10 10 10 11 11 11 11 10 10 11 11 10 11 10 11 10 11 10 10 10 11 10 10 10 10 11 11 10 10 11 11 11 10 11 10 10 11 10 12 12  
13 10 10 10 11 10 11 11 11 10 10 10 11 11 10 10 10 11 10 11 10 10 11 10 11 10 11 10 11 11 10 10 10 10 11 10 11 11 11 10 11 10 11 10 11 10 10 11 12 12  
13 11 10 11 11 10 11 10 10 11 10 10 11 11 11 10 10 10 10 10 10 11 10 10 11 10 11 10 10 11 10 10 10 10 11 11 11 11 10 11 11 11 10 10 11 10 11 10 12 12  
13 11 10 11 11 11 11 10 10 11 10 10 11 11 10 10 11 10 10 10 10 10 11 11 10 11 11 11 10 10 10 11 10 11 11 10 10 11 10 10 10 11 11 11 11 10 10 11 12 12  
13 10 11 10 10 10 10 11 10 11 10 11 10 10 10 11 10 10 11 11 10 11 11 10 10 10 10 11 11 11 10 10 10 11 10 10 10 11 11 10 10 11 10 10 10 10 10 11 12 12  
13 11 10 10 11 11 10 10 11 11 11 11 11 10 11 10 10 11 10 10 11 11 10 11 11 11 11 10 11 11 11 10 10 10 10 10 11 10 10 10 11 10 11 10 11 10 11 10 12 12  
13 10 10 11 10 10 11 11 11 10 10 10 11 10 11 11 11 10 10 10 10 10 11 11 11 10 10 10 10 10 11 11 10 10 11 11 11 11 11 10 10 11 11 11 11 10 10 11 12 12  
13 11 11 11 11 11 11 11 11 11 10 10 11 10 11 11 10 11 11 11 10 11 10 11 10 10 10 11 10 11 11 11 10 11 10 11 10 10 11 11 11 11 11 11 11 11 10 10 12 12  
13 10 10 11 10 10 11 11 10 10 11 11 10 11 10 10 10 10 10 10 10 11 10 10 11 10 10 10 10 10 11 10 11 11 10 11 10 10 10 11 10 11 10 10 11 10 11 11 12 12  
13 11 11 11 11 11 11 11 11 10 10 11 11 11 10 11 10 10 10 11 11 10 10 11 10 10 10 10 10 10 11 10 10 11 11 11 10 10 11 10 11 11 11 10 10 10 11 11 12 12  
13 10 10 10 11 11 10 10 11 10 10 11 10 10 11 11 11 10 10 11 10 11 10 11 11 10 10 11 11 10 11 11 10 10 10 10 10 11 11 11 10 11 11 11 10 10 10 11 12 12  
13 10 11 10 11 10 11 10 10 10 10 10 10 11 11 11 10 11 10 10 11 11 10 10 11 10 11 11 11 11 10 11 11 10 11 11 11 11 10 10 10 11 10 11 10 10 10 11 12 12  
17 14 14 14 14 14 14 14 14 14 14 14 14 14 14 14 14 14 14 14 14 14 14 14 14 14 14 14 14 14 14 14 14 14 14 14 14 14 14 14 14 14 14 14 14 14 14 14 16 16 
17 14 14 14 14 14 14 14 14 14 14 14 14 14 14 14 14 14 14 14 14 14 14 14 14 14 14 14 14 14 14 14 14 14 14 14 14 14 14 14 14 14 14 14 14 14 14 14 16 16