28 30 28 28 28 28 28 28 28 28 28 28 28 28 28 28 28 15 28 15 15 15 15 15 15 15 15 15 15 15 15 15 15 15 15 15 15 15 15 15 15 15 15 15 15 15 15 15 15 15
28 15 15 15 15 15 15 15 15 15 15 15 15 15 15 15 15 15 28 28 28 28 28 28 28 28 28 28 28 28 28 28 28 28 28 28 28 28 28 28 28 28 28 28 28 28 28 28 28 15
28 28 28 28 28 28 28 28 28 28 28 28 28 28 28 28 28 15 28 15 15 15 15 15 15 15 15 15 15 15 15 15 15 15 15 15 15 15 15 15 15 15 15 15 15 15 15 15 28 15
28 15 28 15 28 15 15 15 28 15 15 15 28 15 15 15 28 15 28 15 28 28 28 28 28 28 28 15 28 28 28 28 28 28 28 28 28 28 28 28 28 28 28 28 28 28 28 15 28 15
28 15 28 15 28 15 15 15 28 15 28 15 28 15 28 15 28 15 28 15 15 28 28 15 15 15 28 15 28 15 15 15 28 15 15 15 28 15 15 15 28 15 15 15 28 15 28 15 28 15
28 15 28 15 28 15 28 15 28 15 28 15 28 15 28 15 28 15 28 15 15 28 15 15 28 15 28 15 28 15 28 15 28 15 28 15 28 15 28 15 28 15 28 15 28 15 28 15 28 15
28 15 28 15 28 15 28 15 28 15 28 15 28 15 28 15 28 15 28 15 15 28 15 28 28 15 28 15 28 15 28 15 15 15 28 15 15 15 28 15 15 15 28 15 28 15 28 15 28 15
28 15 28 15 28 15 28 15 28 15 28 15 28 15 28 15 28 15 28 15 15 28 15 15 28 15 28 15 28 28 28 28 28 28 28 28 28 28 28 28 28 28 28 15 28 15 28 15 28 15 
28 15 28 15 28 15 28 15 28 15 28 15 28 15 28 15 28 15 28 15 15 28 28 15 28 15 28 15 15 15 15 15 15 15 15 15 15 15 15 15 15 15 15 15 28 15 28 15 28 15 
28 15 28 15 28 15 28 15 28 15 28 15 28 15 28 15 28 15 28 15 15 28 15 15 28 15 28 15 28 28 28 28 28 28 28 28 28 28 28 28 28 28 28 28 28 15 28 15 28 15 
28 15 28 15 28 15 28 15 28 15 28 15 28 15 28 15 28 15 28 15 15 28 15 28 28 15 28 15 28 15 15 15 15 15 15 15 15 15 15 15 15 15 15 15 15 15 28 15 28 15 
28 15 28 15 28 15 28 15 15 15 28 15 15 15 28 15 15 15 28 15 15 28 15 15 28 15 28 15 28 15 28 28 28 28 28 28 28 28 28 28 28 28 28 28 28 28 28 15 28 15
28 15 28 15 28 28 28 28 28 28 28 28 15 28 28 28 28 15 28 15 15 28 28 15 28 15 28 15 28 15 15 15 15 15 15 15 15 15 15 15 15 15 15 15 15 15 28 15 28 15 
28 15 15 15 15 28 15 28 15 28 15 15 15 15 28 15 15 15 28 15 15 28 15 15 28 15 28 15 28 28 28 28 28 28 28 28 28 28 28 28 28 28 28 28 28 15 28 15 28 15
28 28 28 15 15 28 15 28 15 28 15 28 28 15 28 15 28 15 15 15 15 28 15 28 28 15 28 15 28 15 15 15 15 15 15 15 15 15 15 15 15 15 15 15 15 15 28 15 28 15
36 28 15 15 15 28 15 28 15 28 15 28 15 15 28 15 28 28 28 15 15 28 15 15 28 15 28 15 28 15 28 28 28 28 28 28 28 28 28 28 28 28 28 28 28 28 28 15 28 15
18 28 15 28 15 28 15 28 15 28 15 28 15 28 28 15 28 15 15 15 28 28 28 28 28 15 28 15 28 15 15 15 15 15 15 15 15 15 15 15 15 15 15 15 15 15 28 15 28 15
18 28 15 28 15 28 15 28 15 28 15 28 15 15 28 15 28 15 15 15 15 15 15 15 15 15 15 15 28 28 28 28 28 28 28 28 28 28 28 28 28 28 28 28 28 15 28 15 28 15
18 28 15 28 15 28 15 28 15 28 28 28 28 15 28 15 28 15 28 28 28 28 28 15 15 15 15 15 28 15 15 15 28 15 15 15 28 15 15 15 15 15 15 15 15 15 28 15 28 15 
18 28 15 28 15 28 15 28 15 28 15 15 15 15 28 15 28 15 15 15 15 15 28 15 15 15 15 15 28 15 28 15 28 15 28 15 28 15 28 28 28 28 28 28 28 28 28 15 28 15
18 28 15 28 15 28 14 28 15 28 15 28 28 28 28 15 28 28 28 28 28 15 28 15 15 15 15 15 28 15 28 15 28 15 28 15 28 15 15 15 15 15 15 15 15 15 28 15 28 15
18 28 15 28 15 28 15 28 15 28 15 15 15 15 28 15 28 15 15 15 15 15 28 15 28 28 28 28 28 15 28 15 28 15 28 15 28 28 28 28 28 28 28 28 28 15 28 15 28 15
18 28 15 28 15 28 15 28 15 28 28 28 28 28 28 15 28 15 28 28 28 28 28 15 28 15 15 15 28 15 28 15 28 15 28 15 28 15 15 15 15 15 15 15 15 15 28 15 28 15
18 28 15 28 15 15 15 28 15 15 15 15 15 15 15 15 28 15 15 15 15 15 28 15 28 28 28 15 28 15 28 15 28 15 28 15 28 15 28 28 28 28 28 28 28 28 28 15 28 15
18 28 28 28 28 15 15 15 15 15 15 15 15 15 15 15 28 15 28 15 28 28 28 15 28 15 15 15 28 15 28 15 15 15 28 15 28 15 15 15 15 15 15 15 15 15 28 15 28 15
18 28 15 15 15 15 28 15 28 15 15 15 15 15 15 15 28 15 28 15 15 15 28 15 28 15 28 28 28 15 28 28 15 15 28 15 28 28 28 28 28 28 28 28 28 15 28 15 28 15
18 28 15 28 28 28 28 15 28 28 28 28 28 28 28 15 28 15 28 28 28 15 28 15 28 15 15 15 15 15 15 28 15 15 28 15 15 15 15 15 15 15 15 15 15 15 28 15 28 15
18 28 15 15 15 15 28 15 28 15 15 15 15 15 15 15 28 15 28 15 15 15 28 15 28 15 28 28 15 28 28 28 28 28 28 28 28 28 28 28 28 28 28 28 28 28 28 15 28 15
18 28 28 28 28 15 28 15 28 15 15 15 15 15 15 15 28 15 28 15 28 15 28 15 15 15 15 28 15 15 15 15 15 15 15 15 15 15 15 15 15 15 15 15 15 15 28 15 28 15
18 15 15 15 15 15 28 15 15 15 15 15 15 15 15 15 28 15 28 15 28 15 28 28 28 28 28 28 28 28 28 28 28 28 28 28 28 28 28 28 28 28 28 28 28 15 28 15 28 15
28 15 28 28 28 28 28 28 28 28 28 28 28 28 28 15 28 15 28 15 28 15 15 15 15 15 15 15 15 15 15 15 15 15 15 15 15 15 15 15 15 15 15 15 15 15 28 15 15 15
28 15 28 15 15 15 15 15 15 15 15 15 15 15 15 15 28 28 28 28 28 28 28 28 28 28 28 28 28 28 28 28 28 28 28 28 28 28 28 28 28 28 28 28 28 28 28 28 28 28
28 15 28 15 28 28 28 28 28 28 28 28 28 28 28 28 28 15 15 15 28 15 15 15 15 15 15 15 15 15 15 15 28 15 15 15 15 15 15 15 15 15 15 15 15 15 15 15 15 15
28 15 28 15 15 15 15 15 15 15 15 15 15 15 15 15 28 15 28 15 28 15 28 15 15 15 28 15 15 15 28 15 28 15 28 28 28 28 28 28 28 28 28 28 28 28 28 28 28 15
28 15 28 28 28 28 28 28 28 28 28 28 28 28 28 15 28 15 28 15 28 15 28 15 15 15 28 15 15 15 28 15 28 15 28 15 15 15 15 15 15 15 15 15 15 15 15 15 28 15
28 15 28 15 15 15 15 15 15 15 15 15 15 15 28 15 28 15 28 15 28 15 28 15 15 15 28 15 15 15 28 15 28 15 28 15 28 28 28 28 28 28 28 28 28 28 28 15 28 15
28 15 28 15 28 28 28 28 28 28 28 28 28 15 28 15 28 15 28 15 28 15 28 15 15 15 28 15 15 15 28 15 28 15 28 15 28 15 15 15 28 15 15 15 28 15 28 15 28 15
18 15 28 15 15 28 15 15 15 15 15 15 15 15 28 15 28 15 28 15 28 15 28 15 15 15 28 15 15 15 28 15 28 15 28 15 28 15 28 15 15 15 28 15 15 15 28 15 28 15
18 28 28 28 15 28 15 28 28 28 28 28 28 28 28 15 28 15 28 15 28 15 28 15 15 15 28 15 15 15 28 15 28 15 28 15 28 15 28 28 28 28 28 28 28 15 28 15 28 15
18 28 15 15 15 28 15 15 15 15 15 15 15 15 28 15 28 15 28 15 28 15 28 15 15 15 28 15 15 15 28 15 28 15 28 15 28 15 15 15 15 15 15 15 28 15 28 15 28 15
18 28 15 28 28 28 28 28 28 28 28 28 28 15 28 15 28 15 28 15 28 15 28 15 15 15 28 15 15 15 28 15 28 15 28 15 28 28 28 28 28 28 28 15 28 15 28 15 28 15
18 28 15 15 15 28 15 15 15 15 15 15 15 15 28 15 28 15 28 15 28 15 28 15 15 15 28 15 15 15 28 15 28 15 28 15 28 15 15 15 15 15 15 15 28 15 28 15 28 15
18 28 28 28 15 28 15 28 28 28 28 28 28 28 28 15 28 15 28 15 28 15 28 15 15 15 28 15 15 15 28 15 28 15 28 15 28 15 28 28 28 28 28 28 28 15 28 15 28 15
18 28 15 15 15 28 15 15 15 15 15 15 15 15 28 15 28 15 28 15 28 15 28 15 15 15 28 15 15 15 28 15 28 15 28 15 28 15 15 15 15 15 15 15 28 15 28 15 28 15
18 28 15 28 28 28 28 28 28 28 28 28 28 15 28 15 28 15 28 15 28 15 28 15 15 15 28 15 15 15 28 15 28 15 28 15 28 28 28 28 28 28 28 15 28 15 28 15 28 15
18 28 15 15 15 28 15 15 15 15 15 15 15 15 28 15 28 15 28 15 28 15 28 15 15 15 28 15 15 15 28 15 28 15 28 15 28 15 15 15 15 15 15 15 28 15 28 15 28 15
18 28 28 28 15 28 15 28 28 28 28 28 28 28 28 15 28 15 28 15 28 15 28 15 15 15 28 15 15 15 28 15 28 15 28 15 28 15 28 28 28 28 28 28 28 15 28 15 28 15
18 28 28 15 15 28 15 15 15 15 15 15 15 15 15 15 28 15 28 15 28 15 28 15 15 15 28 15 15 15 28 15 28 15 28 15 28 15 15 15 15 15 15 15 28 15 28 15 15 15
18 15 28 15 28 28 28 28 28 28 28 28 28 28 28 28 28 15 28 15 28 15 28 15 15 15 28 15 15 15 28 15 28 15 28 15 28 28 28 28 28 28 28 15 28 15 28 28 28 28
18 35 28 15 15 15 15 15 15 15 15 15 15 15 15 15 15 15 28 15 15 15 28 15 15 15 28 15 15 15 28 15 15 15 28 15 15 15 15 15 15 15 15 15 28 15 15 15 15 15
28 28 28 28 28 28 28 28 28 28 28 28 28 28 28 28 28 28 28 28 28 28 28 28 28 28 28 28 28 28 28 28 28 28 28 28 28 28 28 28 28 28 28 28 28 28 28 28 28 15 